TTTTTTTTT
T......FT
T..T.TT.T
T.T.....T
T...TT..T
T.T.T..TT
T.T..T..T
T.....T.T
TTTTTTTTT